NO ./img/wood/Wood_128x128-0.xpm
SO ./img/wood/Wood_128x128-1.xpm
WE ./img/wood/Wood_128x128-2.xpm
EA ./img/wood/Wood_128x128-3.xpm

F 220,100,0
C 225,30,0


            1111111111111111
           1100000000000000111
           1100001111111111111111
           11000011             11
           11000011             11
       111111000011             11
      11   1100000111111111111111
      11   1100000000000000000011
      11   110000N000000000000011
      11   1100000000000000000011
      11   1100000000000000000011
       11111100001111111111000011
           11000011       1000011
           11000011       1000011
           11000011       1000011
           11000011       1111111
           11111111
