NO tex/blue_stone.xpm
SO           tex/blue_stone.xpm



         WE tex/blue_stone.xpm
EA tex/blue_stone.xpm

F 97,97,97
C 10,20,50

        11
       1001
       1001
       1001
       1001
       1001
       1001
111111110011111111111111111111111111111111111111111111111111111111111111111111111111111111111111111111111111
1E0000000000000000000000000000000000000000000000000000000000000000000000000000000000000000000000000000000001
111111111111111111111000011111111111111111111100011111111111111111111111111111111111111111111111111111110001
                    100001       10000000000010001                                                     10001
                    100001    11110111111111110001                                                     10001
                    100001    100001         10001                                                     10001
                    100001    101111         10001                                                     10001
                    10000111111111111111111111000111111111                                             10001
                    10000000000000000000000000000000000001                                             10001
                    10000111111111111111111111111111111111                                             10001
                    100001                                                                             10001
                    100001                                                                             10001
                    100001                                                                             10001
                    100001                                                                             10001
                    100001                                                                             10001
                    100001                                                                             10001
                    100001                                                                             10001
                    100001                                                                             10001
                    100001                                                                             10001
                    100001                                                                             10001
                    100001                                                                             10001
                    100001                                                                             10001
                    100001                                                                             10001
                    100001                                                                             10001
                    100001                                                                             10001
                    100001                                                                             10001
                    100001                                                                             10001
                    100001                                                                             10001
                    100001                                                                             10001
                    100001                                                                             10001
                    100001                                                                             10001
                    100001                                                                             10001
                    100001                                                                             10001
                    100001                                                                             10001
                    100001                                                                             10001
                    100001                                                                             10001
                    100001                                                                             10001
                    100001                                                                             10001
                    100001                                                                             10001
                    100001                                                                             10001
                    100001                                                                             10001
                    100001                                                                             10001
                    100001                                                                             10001
                    100001                                                                             10001
                    100001                                                                             10001
                    100001                                                                             10001
                    100001                                                                             10001
                    100001                                                                             10001
                    1000011111111111111111111111111111111111111111111111111111111111111111111111111111110001
                    1000000000000000000000000000000000000000000000000000000000000000000000000000000000000001
                    1000000000000000000000000000000000000000000000000000000000000000000000000000000000000001
                    1000011111111111111111111111111111111111111111111111111111111111111111111111111111110001
                    100001                                                                             10001
                    100001                                                                             10001
                    100001                                                                             11111
                    111111
