NO tex/blue_stone.xpm
SO tex/blue_stone.xpm
WE tex/blue_stone.xpm
EA tex/blue_stone.xpm

F 97,97,97
C 10,20,50

111111111111111111111111111111111111111111111111111111111111111111111111111111111111111111111111111111111111
1E0000000000000000000000000000000000000000000000000000000000000000000000000000000000000000000000000000000001
111111111111111111111111111111111111111111111111111111111111111111111111111111111111111111111111111111111111