NO tex/blue_stone.xpm
SO tex/red_brick.xpm
WE tex/grey_stone.xpm
EA tex/purple_stone.xpm

F 196 ,88,36
C 135,206a,235

1111111111111111111
1001001001001000011
1011000001000001001
1001001001111101111
1001W11000001001001
1000000000000001001
1001111111111001001
1111000100000001011
1000000001000000001
1111111110111111111
