NO tex/blue_stone.xpm
SO tex/blue_stone.xpm
WE tex/blue_stone.xpm
EA tex/blue_stone.xpm

F 97,97,97
C 1 0,20,50

11111
1S001
11111
