NO tex/blue_stone.xpm
SO tex/blue_stone.xpm
WE tex/blue_stone.xpm
EA tex/blue_stone.xpm

F 97,97,97
C 10,20,50

                           11111111111
                        1111000000000011
                      1100000        0001
                    11000              0001
                   1100            000000011
                   110           000       001
           11111111110          00         001
         1111111100000          N           001
        11       010            0          001
       11        010            000       001
       11        010             000000000001
       11        010                   001
       11        010                   001 
       11        010                   001
       11        010                   001 
       11        010                  001
        11       010                  001
         11111111010        000       001
          1111111000       00100      001
                 100       01 10      001
                 100       01 10     001
                  100      01 10     01
                  100      01 100000001
                   1000000001  111111
                   111111111                
