NO ../../img/brick/Brick_128x128.xpm
SO ../../img/brick/Brick_128x128.xpm
WE ../../img/brick/Brick_128x128.xpm
EA ../../img/brick/Brick_128x128.xpm

F 220,100,0
C 225,30,0

111111111
100000001
1000N0000
100000001
111111111