NO tex/blue_stone.xpm
SO tex/blue_stone.xpm
WE tex/blue_stone.xpm
EA tex/blue_stone.xpm

F 220,100,0
C 225,30,0

11111111111111111
100000000000001
1000N00011111111111
10000000000000001
11111111011111111
101    000
101    101
101    101
101    101
101    101
111    111
